Access Mode=Mod de Acces
Add another Path, Port, Variable, Label or Device=Adăugați altă Cale, Poară, Variabilă sau Etichetă
Add Configuration=Adăugați Configurare
Add=Adaugă
Additional Requirements=Cerințe Suplimentare
Always=Mereu
App to Host=Aplicație de Host
Application=Aplicație
apply update=aplică actualizare
Array must be Started to view Docker containers=Array-ul trebuie să fie **Pornit** pentru a putea vedea containerele Docker
Are you sure=Sunteți sigur?
Autostart=Autostart
Back=Înapoi
Backup=Copie de rezervă
Beta=Beta
Books=Cărți
By=By
Categories=Categorii
Check for Updates=Verifică Actualizări
Cloud=Cloud
Config Type=Tip Configurare
Configuration not found=Configurație negăsită
Connection Type=Tip Conexiune
Console shell command=Comandă consolă shell
Container ID=ID Container
Container Path=Cale Container
Container Port=Port Container
Container Size=Mărime Container
Container=Container
CPU Memory load=Folosire CPU & Memorie
CPU Pinning=Pinning CPU
Created=Creat
Crypto Currency=Crypto-Monedă
Default Value=Valoare Implicită
Device=Dispozitiv
Display=Afișaj
DNS=DNS
Docker Containers=Cobtainere Docker
Docker Hub URL=URL Hub Docker
Docker Service failed to start=Serviciul Docker a eșuat de a porni
Downloaders=Descărcători
Drivers=Drivere
Edit Configuration=Editează Configurația
Exited=Ieșit
Extra Parameters=Parametri Extra
Fixed IP address=Adresă IP fixă
force update=forțează actualizare
FTP=FTP
Game Servers=Servere de Jocuri
healthy=sănătos
Hide Buttons=Ascunde Butoane
Hide docker allocations=Ascunde alocările docker
Hide more settings=Ascunde *mai multe setări*
Home Automation=Automatizare Casă
Host Path=Cale Host
Host Port=Port Host
HT=HT
Icon URL=Url Pictogramă
Image ID=ID Imagine
Key=Cheie
Label=Etichetă
Management=Management
MediaApp=MediaApp
MediaServer=MediaServer
Messenger=Messenger
Missing parameters=Parametri lipsă
Music=Muzică
Network Type=Tip Rețea
No Docker containers installed=Niciun container Docker instalat
None Listed=Niciunul Listat
of=din
orphan image=imagine reziduală
Other=Altele
Overview=Prezentare Generală
Path=Cale
Pause All=Pauzează Toate
Photos=Fotografii
Port Mappings=Mapare Porturi
Port=Port
Post Arguments=Post Arguments
Privileged=Privilegiat
Productivity=Productivitate
Project Page=Pagină Proiect
Proxy=Proxy
Pulling image=Descărcare imagine
Read Me First=Citește-mă Primul
Read Only - Shared=Doar în Citire - Partajat
Read Only - Slave=Doar în Citire - Slave
Read Only=Doar în Citire
ReadWrite - Shared=Citire/Scriere - Partajat
ReadWrite - Slave=Citire/Scriere - Slave
rebuild ready=reconstrucția gata
rebuilding=reconstrucție
Remove template=Elimină șablon
Removing container=Se elimină containerul
Removing orphan image=Se elimină imaginea reziduală
Repository=Repository
Required=Necesar
Reset sorting=Resetează sortare
Resume All=Reia Toate
Save=Salvează
Select a template=Selecționați un șablon
Select categories=Selecționați o categorie
Show docker allocations=Arată alocările docker
Show more settings=**Arată** *mai multe setări*
Stable=Stabil
Start All=Pornește Toate
starting up containers=se pornesc containerele
Stop All=Oprește Toate
Stopping container=Se opresc containerele
Successfully removed container=Container eliminat cu succes
Successfully removed orphan image=Imagine reziduală eliminată cu succes
Successfully stopped container=Oprire container cu succes
Support Thread=Fir de Suport
Template URL=URL Șablon
Template=Șablon
The command failed=Comanda a eșuat
The command finished successfully=Comanda s-a terminat cu succes
TOTAL DATA PULLED=TOTALUL DATELOR EXTRASE
Total size=Mărime totală
Unknown action=Acțiune necunoscută
Update All=Actualizează Toate
update ready=gata de actualizare 
Value=Valoare
Variable=Variabilă
Video=Video
Voip=VoIP
Volume Mappings=Mapare Volume
wait=așteaptă
Was this container created using this plugin=A fost creat acest container folosind acest plugin
Web=Web
WebUI=Interfață utilizator Web
Writable=Inscriptibil
