A format is NEVER part of a data recovery or disk rebuild process and if done in such circumstances will normally lead to loss of all data on the disks being formatted=O formatare **NICIODATĂ** face parte dintr-un proces de recuperare a datelor sau de reconstrucție a discului și, dacă este făcut în astfel de circumstanțe, va duce în mod normal la pierderea tuturor datelor de pe discurile formatate.
Aborted=Întrerupt
Action=Acțiune
Add=Adaugă
Add Pool=Adaugă Pool
All existing data on this device will be OVERWRITTEN when array is Started=Toate datele existente pe dispozitiv vor fi **SUPRASCRISE** când array-ul este Pornit
Array Devices=Dispozitive în Array
Array of %s devices=Array din %s dispozitive
Array Operation=Operare Array
Attribute Name=Nume Atribut
Attributes=Atribute
Attributes not available=Atribute indisponibile
auto=auto
Balance Status=Status Balanță
Balance=Balanță
Blacklisted=În lista neagră
Boot Device=Dispozitiv pentru Boot
Boot system in UEFI mode=Bootează sistemul în modul UEFI
btrfs balance status=status balanță btrfs
btrfs check status=verificare status btrfs
btrfs filesystem df=sistem de fișiere btrfs df
BTRFS operation is running=operațiunea BTRFS rulează
btrfs scrub status=btrfs scrub status
Canceled=Anulat
Cannot contact key-server Please check your=Nu se poate contacta serverul de chei. Vă rugăm să vă verificați
Capabilities=Capabilități
Capabilities not available=Capabilități indisponibile
Check Filesystem Status=Verifică Statut Sistem de Fișiere
Clear Stats=Șterge Statistici
Clearing in progress=Curățare în derulare
Click on FLASH above this message=Faceți clic pe **FLASH** deasupra acestui mesaj
Click to spin down device=Faceți clic pentru a opri dispozitivul
Click to spin up device=Faceți clic pentru a porni dispozitivul
Comments=Comentarii
complete=complet
completed=completat
Completed without error=Completat fără erori
Configuration valid=Configurație validă
Convert to raid0 mode=Convertiți la modul raid0
Convert to raid1 mode=Convertiți la modul raid1
Convert to raid10 mode=Convertiți la modul raid10
Convert to raid1c3 mode=Convertiți la modul raid1c3
Convert to raid1c4 mode=Convertiți la modul raid1c4
Convert to raid5 mode see help=Convertiți în modul raid5 *vezi ajutor
Convert to raid6 mode see help=Convertiți în modul raid6 *vezi ajutor
Convert to single mode=Convertiți la modul unic
Copying=Se copiază
corrected=corectat
Create an empty file system on the disks shown as Unmountable discarding all data currently on the disks and update parity to reflect this=Creați un sistem de fișiere gol pe discurile afișate ca **Unmountable** eliminând toate datele aflate în prezent pe discuri și actualizați paritatea pentru a reflecta acest lucru
Creating Flash backup=Se creează copia de rezervă a Unității Flash
creating Flash backup zip file this may take several minutes=se crează copia de rezervă în fișier ZIP al unității Flash (acest lucru poate dura câteva minute)
Creation error=Eroare la creare
Critical disk temperature threshold=Prag critic al temperaturii discului
Critical disk utilization threshold=Prag critic de utilizare al discului
Current operation %s on %s=Operațiunea curentă este %s din **%s**
Current position=Poziție curentă
Custom attributes use comma to separate numbers=Atribute personalizate (folosiți virgula pentru a separa numerele)
Data-Rebuild in progress=Reconstrucție-Date în curs
Date of purchase=Data cumpărării
Date=Dată
Delete Pool=Șterge Pool
detected=detectat
Device encrypted and unlocked=Dispozitiv criptat și deblocat
Device encrypted=Dispozitiv criptat
Device is part of a pool=Dispozitivul face parte dintr-un pool
Device locked unknown error=Dispozitiv blocat: eroare necunoscută
Device locked wrong encryption key=Dispozitiv blocat: cheie de criptare greșită
Device to be encrypted=Dispozitiv ce urmează a fi criptat
Disable Spin down delay to run a SMART extended self-test=Dezactivați **Întârzierea Spin-down** pentru a rula un autotest extins SMART
Disk in parity slot is not biggest=Discul din slotul de paritate nu este cel mai mare
Disk Log Information=Informațiid de jurnal de disc
Disk-Clear in progress=Curățare-Disc în curs
Do not use reserved names=**Nu folosiți** *nume rezervate*
Do not use user share names=**Nu folosiți** nume ale partajărilor utilizatorului
Download SMART report=Descarcă raportul SMART
Dual parity valid requires ALL disks in their original slots=*Dual parity* valid necesită **TOATE** discurile în sloturile lor originale
Elapsed time=Timp scurs
Enable user share assignment=Activați atribuirea partajării utilizatorilor
enter disk index and device name as applicable to your controller=Introduceți indexul discului și numele dispozitivului, după caz, în controller-ul dvs.
Erase Device Content=Șterge Conținutul Dispozitivului
encrypted=criptat
Encryption input=Intrare criptare
Encryption status=Status criptare
Enter new key=Intoduceți o cheie nouă
Errors occurred - Check SMART report=Au apărut erori - Verificați raportul SMART.
Estimated finish=Timp estimat de finalizare
Estimated speed=Viteză estimată
Existing content is permanently lost=Conținutul existent este pierdut permanent
Failed=Eșuat
Feature=Funcționalitate
File system status=Status sistem de fișiere
File system type=Tipul sistemului de fișiere
Finding %s error=S-a găsit: **%s** eroare
Finding %s errors=S-au găsit: **%s** erori
Flag=Steag
Flash backup=Copie de rezervă flash
Flash device is set as public share= Dispozitivul flash este setat ca partajare publică
Flash Device Settings=Setări Dispozitiv Flash
Format Unmountable disks=Formatează discurile Nemontabile
Formatting=Se formatează
formatting=se formateazănevalidă
Free=Liber
FS=FS
Global Configuration=Configurație Globală
Hide=Ascunde
Identification=Identificare
Identity=Identitate
Identity is not available=Identitatea nu este disponibilă
if checked, Start array but do not mount disks=Dacă este selectat, pornește array-ul dar nu monta discurile.
If this is a new array, move the largest disk into the parity slot=Dacă aceasta este o matrice nouă, mutați cel mai mare disc în slotul *parity*.
Dacă adăugați un disc nou sau înlocuiți un disc dezactivat, încercați Swap-Paritate=
Information=Informație
Insufficient free disk space available=Spațiu liber pe disc insuficient
Interrupted=Întrerupt
Invalid configuration=Configurație nevalidă
invalid device=dispozitiv nevalid
invalid devices=dispozitive nevalide
Invalid expansion=Expansiune nevalidă
Invalid pool name=Nume pool nevalid
Invalid, missing or expired=Nevalid, lipsă sau expirat
is only available when array is Started in Maintenance mode=este disponibil doar atunci când array-ul este Pornit în modul de **Mentenanță**.
is only available when array is Started=este disponibil doar atunci când array-ul este Pornit
Keyfile=Fișier cheie
Last check completed on %s=Ultima verificare la **%s**
Last check incomplete on %s=Ultima verificare incompletă la **%s**
Last checked on %s=Ultima verificare la **%s**
Last SMART test result=Ultimele rezultate ale testului SMART
Maintenance mode=Mod mentenanță
Maintenance Mode=Mod Mentenanță
Maintenance=Mentenanță
Manufacturing date=Dată fabricare
Menu View=Vizualizare meniu
Minimum free space=Spațiu liber minim
Missing Cache disk=Lipsește discul Cache
Missing disk=Disc lipsă
Missing key=Cheie lipsă
Missing=Lipsă
Mounted=Montat
Mover is running=*Mover*-ul rulează
network settings=setări de rețea
next device=următorul dispozitiv
New data disks detected=Discuri noi pentru date detectate.
No array data disks have been assigned=Nu au fost atribuite discuri de date pentru array.
No data disks=Niciun disc pentru date
No parity check history present=Istoric verificare paritate lipsă
No self-tests logged on this disk=Niciun auto-test înregistrat pe acest disc
Not installed=Neinstalat
OK=OK
Once copy completes, the array may be Started, to initiate Data-Rebuild of the disabled disk=După ce copierea se completează, array-ul poate fi pornit pentru a iniția Reconstrucția-Datelor pe discul dezactivat.
operation=operațiune
Options see Help=Opțiuni (vezi Ajutor)
Otherwise use the keyfile method for UTF8 input=În caz contrar, utilizați metoda **fișier cheie** pentru intrare UTF8
Parity disks content will be overwritten=Conținutul discului de *Paritate* va fi suprascris
Parity is already valid=Paritatea este deja validă
Parity operation is running=Operațiunea paritate rulează
Parity valid requires ALL disks to have their original content=*Paritate validă* necesită ca **TOATE** discurile să aibă conținutul lor original
Parity-Check in progress=Verificare-Paritate în derulare
Parity Operation History=Istoric Operațiune Paritate
ParityRead-Check History=Istoric Verificare-Paritate/Verificare-Citire
Parity-SyncData-Rebuild in progress=Sinconizare-Paritate/Reconstrucție-Date în desfășurare
Parity-Sync in progress=Sinconizare-Paritate în desfășurare
Partition format=Formatare partiție
Partition size=Mărime partiție
Passed=Trecut
Passphrase=Parolă
Perform full balance=Realizați balansarea completă
Permit UEFI boot mode=Permiteți modul de bootare UEFI
Please change share SMB security=Vă rugăm să schimbați securitatea SMB a partajării
Please check your system settings to support UEFI boot mode=Vă rugăm să verificați setările sistemului pentru a suporta modul de bootare UEFI
Pool Devices=Dispozitive de Pool
Pool name already exists=Nume Pool deja existent
Pool of %s devices=Pool din %s dispozitive
Preclear in progress=Pre-Clear în desfășurare
previous device=dispozitive anterioare
Printable Characters Only=Doar Caractere Imprimabile
Proceed to start=Continuați cu pornirea
Raw Value=Valoare Brută
Raw View=Vizualizare Brută
Read-Check in progress=Verificare-Citire în desfășurare
Reading=Se citește
Reboot in safe mode=Repornește în *mod siguranță*
registration key=cheie înregistrare
Registration Key Manager=Manager Chei de Înregistrare
reiserfsck status=status reiserfsck
Rename Pool=Redenumiți Pool
Repair corrupted blocks=Reparați blocurile corupte
Replacement disk installed=Disc de înlocuire instalat
Replacement disk is too small=Discul de înlocuire este prea mic
Retype passphrase=Rescrie parola
Schedule=Programare
Scrub Status=Status Scrub
Scrub=Scrub
See %s Settings=Vedeți Setările %s
self-test in progress=auto-test în desfășurare
Self-Test=Auto-Test
Server boot mode=Mod bootare al serverului
Set default boot menu=Setați meniul de bootare implicit
show passphrase=arată parola
Show=Arată
Slots=Sloturi
SMART attribute notifications= Notificări ale atributelor SMART
SMART controller type=Tip controller SMART
SMART error log=Jurnal de erori SMART
SMART extended self-test=Test de autoevaluare extins SMART
SMART health-check failed=Verificarea stării de sănătate SMART a eșuat
SMART notification tolerance level=Nivelul de toleranță al notificărilor SMART
SMART notification value=Valoarea notificării SMART
SMART self-test history=Istoric autoevaluare SMART
SMART self-test in progress=Autoevaluare SMART în curs
SMART Settings=Setări SMART
SMART short self-test=Autoevaluare rapidă SMART
SMART status=status SMART
Speed=Viteză
Spin down delay=Întârziere la oprirea rotației
Spin Down=Oprește Rotația
Spin Up=Pornește Rotația
Spinup groups=Grupuri de pornire a rotației
Started, array protected=Pornit, array protejat 
Started, array unprotected=Pornit, array neprotejat
Started, clearing=Pornit, se curăță
Started, formatting=Pornit, se formatează
Starting, copying=Pornit, se copiază
Starting=Se pornește
Stopping=Se oprește
Sync errors=Erori de sincronizare
Sync errors corrected=Erori de sincronizare corectate
Sync errors detected=Erori de sincronizare detectate
Sync=Sinconizare
Syslinux Configuration=Configurație Syslinux
Syslinux configuration=configurație Syslinux
Temp=Temp
The array will be immediately available, but unprotected since parity has not been assigned=Array-ul va fi disponibil imediat, dar **neprotejat** deoarece *paritatea* nu a fost atribuită
The array will be immediately available, but unprotected until Parity-Sync completes=Array-ul va fi disponibil imediat, dar **neprotejat** până când sincronizarea parității se va finaliza
The replacement disk must be as big or bigger than the original=Discul de înlocuire trebuie să fie la fel de mare sau mai mare decât cel înlocuit
This is typically done when a new disk is added to the array to get it ready for files to be written to it=Aceasta se face de obicei atunci când un disc nou este adăugat în matrice pentru a fi pregătit pentru a fi scris pe el fișiere
This Unraid OS release has been withdrawn and may no longer be used Please=Această versiune a sistemului de operare Unraid a fost retrasă și nu mai poate fi utilizată. Vă rugăm
This will ERASE ALL device content=Aceasta va **ȘTERGE TOT** conținutul dispozitivului
This will ERASE content of ALL devices in the pool=Aceasta va **ȘTERGE** conținutul de pe **TOATE** dispoizitivele din pool
This will reboot the system=Aeasta va reporni sistemul
This will shutdown the system=Aceasta va opri sistemul
This will stop the array=Aceasta va opri array-ul
This will stop the running operation=Aceasta va opri operațiunile în curs
Threshold=Prag
Title=Titlu
To confirm your action type %s=Pentru a confirma acțiunea dvs., tastați: %s
Toggle readswrites display=Comută afișarea citirilor/scrierilor
Too many attached devices Please consider upgrading your=Prea multe dispizitive atașate. Vă rugăm luați în considerare să vă actualizați
Too many wrong andor missing disks=Prea multe discuri greșite/lipsă
Total size=Mărime totală
Unassign ALL devices to delete this pool=Dezasociați **TOATE** dispozitivele pentru a șterge acest grup
Unassigned Devices=Dispozitive Neasociate
unavailable no parity-check entries logged=indisponibil (nicio intrare de verificare a parității înregistrată)
Unavailable - disk must be spun up=Indisponibil - discul trebuie pornit
Unavailable=Indisponibil
Unclean shutdown detected=Oprire necorespunzătoare detectată
Unmountable disk present=Disc prezent ce nu poate fi montat
Unmountable disks present=Discuri prezente ce nu pot fi montate
Unmountable Encrypted volume present=Nemontabil: Prezent volum criptat
Unmountable Missing encryption key=Nemontabil: Lipsește cheia de criptare
Unmountable No file system=Nemontabil: Fără sistem de fișiere
Unmountable No pool uuid=Nemontabil: UUID grup lipsă
Unmountable not btrfs pool=Nemontabil: lipsă grup btrfs
Unmountable Unsupported or no file system=Nemontabil: Sistem de fișiere inexistent sau nesuportat
Unmountable Volume not encrypted=Nemontabil: Volumul nu este criptat
Unmounted=Nemontat
Upgrading diskswapping parity=Actualizarea discului/ schimbarea parității
Use ASCII characters from space to tilde=Utilizați caractere **ASCII** de la spațiu ' ' până la tildă '~'
Use Default=Folosiți Implicit
Use default=Folosiți implicit
Use only lowercase with no special characters or leadingtrailing digits=Utilizați doar litere mici fără caractere speciale sau cifre la început/sfârșit
use printable characters only=folosiți doar caractere Imprimabile
Used=Folosit
Value=Valoare
WARNING canceling may leave the array unprotected=**AVERTISMENT**: anularea poate lăsa array-ul neprotejată
Warning disk temperature threshold=Avertisment: prag temperatură disc
Warning disk utilization threshold=Avertisment: prag utilizare disc
WARNING=AVERTISMENT
Warranty period=Perioadă garanție
will activate a clean system power down=va activa o oprire *curată* a sistemului
will activate a clean system reset=va activa un restart *curat* al sistemului
will bring the array on-line and start Clearing new data disks=va aduce array-ul on-line și va începe **Curățarea** noului/lor disc/urilor de date
will bring the array on-line and start Data-Rebuild=va aduce array-ul on-line și va începe **Reconstrucție-Date**
will bring the array on-line and start Disk-Clear of new data disks=va aduce array-ul on-line și va începe **Curățare-Disc** pentru discul/urile nou/i
will bring the array on-line and start Parity-Check=va aduce array-ul on-line și va începe **Verificare-Paritate**
will bring the array on-line and start Parity-Sync=va aduce array-ul on-line și va începe **Sinconizare-Paritate**
will bring the array on-line and start Parity-Sync andor Data-Rebuild=va aduce array-ul on-line și va începe **Sinconizare-Paritate** și/sau **Reconstrucție-Date**
will bring the array on-line=va aduce array-ul on-line
will copy the parity information to the new parity disk=va copia informațiile pen noul disc de *paritate*
will create a file system in all Unmountable disks=va crea un sistem de fișiere pe toate discurile **Nemontabile**
will delete the encryption keyfile=va șterge fișierul cheie pentru criptare
will disable the missing disk and then bring the array on-line Install a replacement disk as soon as possible=va dezactiva discul lipsă și apoi va aduce array-ul on-line. Instalați un disc de înlocuire cât mai curând posibil
will expand the file system of the data disk if possible then bring the array on-line and start Data-Rebuild=va extinde sistemul de fișiere al discului de date (dacă este posibil); apoi va aduce array-ul on-line și va începe Reconstrucție-Date
will immediately clear all disk statistics=va curăța imediat toate statisticile despre discuri
will immediately invoke the Mover=va invoca imediat *Mover*-ul
will immediately spin down all disks=va opri imediat toate discurile
will immediately spin up all disks=va porni imadiat toate discurile
will pause the Clearing=va pune în pauză **Curățarea**
will pause the Parity-Check=va pune în pauză **Verificare-Paritate**
will pause the Parity-SyncData-Rebuild=va pune în pauză **Sinconizare-Paritate/Reconstrucție-Date**
will pause the Read-Check=va pune în pauză **Verificare-Citire**
will pause Data-Rebuild=va pune în pauză **Reconstrucție-Date**
will pause Disk-Clear=va pune în pauză **Curățare-Disc**
will pause Parity-Check=va pune în pauză **Verificare-Paritate**
will pause Parity-Sync=va pune în pauză **Sinconizare-Paritate**
will pause Read-Check=va pune în pauză **Verificare-Citire**
will record all disk information and bring the array on-line=va înregistra toate informațiile despre disc și va aduce arrray-ul on-line
will record all disk information, bring the array on-line, and start Parity-Sync=va înregistra toate informațiile despre disc, va aduce array-ul online și va porni *Sinconizare-Paritate*
will remove the missing cache disk and then bring the array on-line=va elimina discul cache lipsă și apoi va aduce array-ul on-line
will resume the paused Clearing=va relua din pauză Curățare
will resume the paused Parity-Check=va relua din pauză Verificare-Paritate
will resume the paused Parity-SyncData-Rebuild=va relua din pauză Sinconizare-Paritate/Reconstrucție-Date
will resume the paused Read-Check=va relua din pauză Verificare-Citire
will resume Data-Rebuild=va relua Reconstrucție-Date
will resume Disk-Clear=va relua Curățare-Disc
will resume Parity-Check=va relua Verificare-Paritate
will resume Parity-Sync=va relua Sinconizare-Paritate
will resume Read-Check=va relua Verificare-Citire
will start Clearing new data disks=va porni **Curățare** disc(uri) nou(noi)
will start Parity-Sync andor Data-Rebuild=va porni **Sinconizare-Paritate** și/sau **Reconstrucție-Date**
will start Disk-Clear of new data disks=va porni **Curățare-Disc** disc(uri) nou(noi)
will start Parity-Check=va porni **Verificare-Paritate**
will start Data-Rebuild=va porni **Reconstrucție-Date**
will start Parity-Sync=va porni **Sinconizare-Paritate**
will start Read-Check of all array disks=va porni **Verificare-Citire** pe toate discurile din array
will stop Parity-SyncData-Rebuild=va opri Sinconizare-Paritate/Reconstrucție-Date
will stop the Parity-Check=va opri Verificare-Paritate
will stop the Read-Check=va opri Verificare-Citire
will stop Clearing=va opri Curățare
will stop Disk-Clear=va opri Curățare-Disc
will stop Data-Rebuild=va opri Reconstrucție-Date
will stop Parity-Check=va opri Verificare-Paritate
will stop Parity-Sync=va opri Sinconizare-Paritate
will stop Read-Check=va opri Verificare-Citire
will take the array off-line=va pune array-ul offline
Worst=Cel mai rău
Write corrections to parity=Scrie corecțiile parității
Writes=Scrieri
Wrong key=Cheie greșită
xfs_repair status=status xfs_repair
You may not add new disks and also remove existing disks=Nu puteți adăuga discuri noi și, de asemenea, elimina discuri existente
your server=serverul d-voastră

; Sleep plugin translations
Check this=Verificați aceasta
for more information=pentru mai multe informații
Make sure your server supports S3 sleep=Asigurați-vă că serverul dvs. acceptă repaus S3
Sleep will immediately put the server in sleep mode=**Repaus** va pune imediat serverul în modul de repaus
Sleeping=În modul repaus
System in sleep mode=Sistemul în mod repaus
This will put the system in sleep mode=Aceasta va pune sistemul pe modul repaus
wiki entry=intrare wiki
