20 EHCI=2.0 (EHCI)
30 nec XHCI=3.0 (nec XHCI)
30 qemu XHCI=3.0 (qemu XHCI)
9p Mode=
Advanced tuning options=Opțiuni avansate de ajustare
Allocation=Alocare
and if using graphics device passthrough it too needs UEFI=iar dacă folosești redirecționarea plăcii grafice, și aceasta necesită UEFI
Are you sure=Ești sigur
Array must be started to view Virtual Machines=Array-ul trebuie să fie **pornit** pentru a vizualiza Mașinile Virtuale
Autostart=Pornire automată
Back=Înapoi
Base Image=Imagine de bază
Block Devices=Dispozitive de bloc
Boot Order=Ordine de boot
Boot order=Ordine de boot
Bus=Bus
Capacity=Capacitate
CD1 ISO Image=Imagine ISO CD1
CD2 ISO Image=Imagine ISO CD2
Change Icon=Schimbă pictograma
Check free space=Verifică spațiul liber
Cleanup=Curățare
Click and Select cdrom image to install operating system=Fă clic și selectează imaginea CD-ROM pentru a instala sistemul de operare
Clock Offset=Decalaj ceas
Clocks Offset=Decalaj ceasuri
Clocks=Ceasuri
Clone=Clonează
Config Folder=Folder de configurare
Copy Paste Domain XML Configuration Here=Copiază &amp; lipește configurația XML a domeniului aici
CPU Mode=Mod CPU
CPUs=Procesoare
Create=Crează
CreateModify Template=Crează/Modifică șablon
Creating=Se creează
DateTime=Dată/Ora
define if migratable=definește dacă este migrabil
define Multifunctiion Support=definește suportul multifuncțional
define OS boot options=definește opțiunile de boot pentru sistemul de operare
define the amount memory=definește cantitatea de memorie
define the maximum amount of memory=definește cantitatea maximă de memorie
define type of cpu presented to this vm=definește tipul de CPU prezentat acestei mașini virtuale
Description=Descriere
description of virtual machine=descrierea mașinii virtuale
Discard=Renunță
Disk devices=Dispozitive de disc
Disk devicesVolume=Dispozitive de disc/Volum
Disk IO=I/O disc
Download Folder=Folder de descărcare
Download, Click and Select virtio drivers image=Descarcă, fă clic și selectează imaginea cu driverele virtio
Downloading=Se descarcă
Edit VM after clone=Editează VM după clonare
eg=e.g.=de exemplu
Eject CD Drive=Ejectează unitatea CD
Emulated=Emulat
Enable USB boot=Activează boot de pe USB
Enter name=Introdu nume
ETA=Timp estimat
Evdev Device=Dispozitiv Evdev
Extracting=Se extrage
Files being removed=Fișiere în curs de eliminare
Folder to save the LibreELEC image to=Folderul unde se va salva imaginea LibreELEC
Folder to save the OpenELEC image to=Folderul unde se va salva imaginea OpenELEC
Form View=Vizualizare formular
free=liber
FS Native Snapshot=Instantaneu nativ FS
grab options=opțiuni de captare
Grab Toggle=Comutare captare
Grab=Captare
Graphics Card=Placă video
Graphics ROM BIOS=BIOS ROM grafic
Graphics=Grafică
Guest agent not installed=Agentul invitat nu este instalat
Guest CPU=CPU al invitatului
Guest not running or guest agent not installed=Invitatul nu rulează sau agentul invitat nu este instalat
Guest not running=Invitatul nu rulează
Hide inline xml=Ascunde XML-ul în linie
Host CPU=CPU gazdă
Host Passthrough=Passthrough gazdă
Hyperv tweaks for Windows=Optimizări HyperV pentru Windows
Hyper-V=Hyper-V
i440fx will work for most=i440fx va funcționa pentru majoritatea
Icon=Pictogramă
If name already exists it will be replaced=Dacă numele există deja, va fi înlocuit
Initial=Inițial
Insert CD=Introdu CD
Insert=Introdu
Interfaces=Interfețe
Invalid storage path=Cale de stocare invalidă
Invalid VM to edit=Mașină virtuală invalidă pentru editare
IP Address=Adresă IP
ISO Image=Imagine ISO
ISO storage path doesnt exist, please create the user share or empty folder first=Calea de stocare ISO nu există, te rugăm creează partajarea de utilizator (sau un folder gol) mai întâi
ISO storage path doesnt exist=Calea de stocare ISO nu există
ISO storage path was empty=Calea de stocare ISO era goală
keyboard for VM Console=tastatură pentru consola VM
keyboard for VNC=tastatură pentru VNC
Leaving blank will use OS name=Lăsând gol se va folosi numele sistemului de operare
LibreELEC Version=Versiunea LibreELEC
LibreELEC=LibreELEC
Libvirt Service failed to start=Serviciul Libvirt nu a pornit
Location of virtual machine files=Locația fișierelor mașinii virtuale
Lock sortable items=Blochează elementele sortabile
Logical CPUs=Procesoare logice
Machine=Mașină
Manual=Manual
Max=Maxim
MD5 verification failed, your download is incomplete or corrupted=Verificarea MD5 a eșuat, descărcarea este incompletă sau coruptă
Memory dump=Dump de memorie
Memory inuseCurrentMaximum=Memorie utilizată/Curent/Maxim
Migratable=Migrabil
Mode=Mod
mount tag inside vm=etichetă de montare în interiorul VM-ului
Multifunction=Multifuncțional
My Workstation=Stația mea de lucru
Name contains invalid characters or does not start with an alphanumberic for a ZFS storage locationOnly these special characters are valid Underscore _ Hyphen - Colon Period=Numele conține caractere invalide sau nu începe cu un caracter alfanumeric pentru o locație de stocare ZFS<br>Doar aceste caractere speciale sunt permise: underscore (_) cratimă (-) două puncte (:) punct (.)
name of mount tag inside vm=numele etichetei de montare în interiorul VM-ului
Name of virtual machine=Numele mașinii virtuale
Network Bridge=Bridge de rețea
Network IO=I/O rețea
Network MAC=MAC rețea
Network Model=Model rețea
Network Source=Sursă rețea
New VM=Mașină virtuală nouă
No CD image inserted in to drive=Nu este introdusă nicio imagine CD în unitate
No CD image inserted into drive=Nu este introdusă nicio imagine CD în unitate
No GPU=Fără placă video
No Virtual Machines installed=Nu sunt instalate mașini virtuale
None available=Niciuna disponibilă
Not enough free space, need at least=Spațiu liber insuficient, este nevoie de cel puțin
Not running=Nu rulează
Not set=Neconfigurat
OpenELEC Version=Versiunea OpenELEC
OpenELEC=OpenELEC
Optional=Opțional
OS Install CDRom Bus=Bus CD-ROM instalare OS
OS Install ISO=ISO instalare OS
Other PCI Devices=Alte dispozitive PCI
Other XML=Alt XML
Override Storage Location=Suprascrie locația de stocare
Overwrite=Suprascrie
OVMF requires a UEFI-compatable OS=OVMF necesită un sistem de operare compatibil cu UEFI
OVMF TPM=OVMF TPM
OVMF=OVMF
Parent=Părinte
password for VM Console=parolă pentru consola VM
password for VNC=parolă pentru VNC
path of Unraid share=calea partajării Unraid
path on Unraid share to save LibreELEC settings=calea pe partajarea Unraid pentru salvarea setărilor LibreELEC
path on Unraid share to save OpenELEC settings=calea pe partajarea Unraid pentru salvarea setărilor OpenELEC
Path to ROM BIOS file=Calea către fișierul ROM BIOS
Pivot=Punct pivot
Please choose a folder the LibreELEC image will download to=Te rugăm să alegi un folder în care să se descarce imaginea LibreELEC
Please choose a folder the OpenELEC image will download to=Te rugăm să alegi un folder în care să se descarce imaginea OpenELEC
Pop-up Blocker is enabled Please add this site to your exception list=Blocatorul de ferestre pop-up este activat! Te rugăm să adaugi acest site în lista de excepții
port for virtual console=port pentru consola virtuală
Prefix=Prefix
Present=Prezent
Primary=Primar
protocol for virtual console=protocol pentru consola virtuală
Q35 for a newer machine model with PCIE=Q35 pentru un model de mașină mai nou cu PCIE
QEMU Command Line=Linie de comandă QEMU
QEMU64=QEMU64
random mac, you can supply your own=mac aleator, poți introduce unul propriu
re-generate random mac address=regenerează adresa mac aleatorie
Rename disabled, %s snapshots exists=Redenumirea este dezactivată, există %s snapshot(uri)
Remove all files=Șterge toate fișierele
Remove Images=Șterge imaginile
Remove LibreELEC image=Șterge imaginea LibreELEC
Remove Meta=Șterge Meta
Remove OpenELEC image=Șterge imaginea OpenELEC
Remove this LibreELEC file=Șterge acest fișier LibreELEC
Remove this OpenELEC file=Șterge acest fișier OpenELEC
Remove User Template=Șterge șablonul utilizatorului
Repeat=Repetă
Requires guest agent installed=Necesită agentul invitat instalat
Requires guest running=Necesită ca invitatul să ruleze
SeaBIOS will work for most=SeaBIOS va funcționa pentru majoritatea
SeaBIOS=SeaBIOS
Select ISO image=Selectează imagine ISO
Select ISO=Selectează ISO
Select ISOs for CDROMs=Selectează ISO-uri pentru CD-ROM-uri
Select the BIOS=Selectează BIOS-ul
Select the LibreELEC version to use=Selectează versiunea LibreELEC de utilizat
Select the machine model=Selectează modelul mașinii
Select the OpenELEC version to use=Selectează versiunea OpenELEC de utilizat
Select the USB Controller to emulate=Selectează controlerul USB de emulat
Select=Selectează
Separate sub-folder and image will be created based on Name=Un subfolder și o imagine vor fi create pe baza numelui
Serial=Serial
Set discard option=Setează opțiunea discard
Set SDD flag=Setează indicatorul SDD
shares=partajări
Show Inline XML=Afișează XML-ul în linie
Snapshot Method=Metodă snapshot
Snapshot Name=Nume snapshot
Snapshot=Snapshot
Snapshots being removed=Snapshot-uri în curs de eliminare
Snapshots=Snapshot-uri
Some OSes wont support USB3=Unele sisteme de operare nu suportă USB3
Sound Card=Placă de sunet
Specify a ISO storage path first=Specifică mai întâi o cale de stocare ISO
SSD=SSD
Start All=Pornește tot
Start Cloned VM=Pornește VM clonat
Start VM after creation=Pornește VM după creare
Stop All=Oprește tot
Template Name=Nume șablon
Tickpolicy=Politică de bifare
Timer Source=Sursă cronometru
Toggle VM autostart=Comută pornirea automată a VM-ului
Top Image=Imagine superioară
Type Method=Tip (Metodă)
type of storage image=tipul imaginii de stocare
Unchecked will use QEMU External Snapshot=Nebifarea va folosi Snapshot extern QEMU
Unknown action=Acțiune necunoscută
Unknown version=Versiune necunoscută
Unlock sortable items=Deblochează elementele sortabile
Unraid Mount tag=Etichetă de montare Unraid
Unraid Mount Tag=Etichetă de montare Unraid
Unraid Share Mode=Mod partajare Unraid
Unraid Share=Partajare Unraid
Unraid Source Path=Calea sursei Unraid
Updating=Se actualizează
USB Controller=Controler USB
USB Devices=Dispozitive USB
vDisk Bus=Bus vDisk
vDisk Location=Locație vDisk
vDisk Size=Dimensiune vDisk
vDisk Type=Tip vDisk
vDisks vCDs=vDisks / vCD-uri
vDisks=vDiscuri
Verifying=Se verifică
video for VM Console=video pentru consola VM
video for VNC=video pentru VNC
VirtIO Drivers CDRom Bus=Bus CD-ROM drivere VirtIO
VirtIO Drivers ISO=Imagine ISO drivere VirtIO
Virtiofs Mode=Mod Virtiofs
Virtual Machines=Mașini virtuale
Virtual=Virtual
VM Being Cloned=VM în curs de clonare
VM Being removed=VM în curs de ștergere
VM Clone=Clonă VM
VM Console AutoPort=AutoPort consolă VM
VM Console enable Copypaste=Activare Copy/paste consolă VM
VM Console Keyboard=Tastatură consolă VM
VM Console Password=Parolă consolă VM
VM Console Port=Port consolă VM
VM Console Protocol=Protocol consolă VM
VM Console Video Driver=Driver video consolă VM
VM Console WS Port=Port WS consolă VM
VM creation error=Eroare creare VM
VM image deletion error=Eroare ștergere imagine VM
VM Name=Nume VM
VM Usage Statisics=Statistici utilizare VM
VNC Keyboard=Tastatură VNC
VNC Password=Parolă VNC
VNC Video Driver=Driver video VNC
VNC=VNC
Warning removing Snapshots can break the chain=Avertisment: ștergerea snapshot-urilor poate întrerupe lanțul
Wasnt able to stop the process=Nu s-a putut opri procesul
Web UI to start from menu=Interfața web pentru pornire din meniu
Web UI to start=Interfață web de pornire
WebUI=Interfață web
Windows 7XP=Windows 7/XP
Windows 82012, newer Linux distros=Windows 8/2012, distribuții Linux mai noi
wsport for virtual console=wsport pentru consola virtuală
XML View=Vizualizare XML
